0000033300000000000000000000000000000000000000000000000000000000000000000000000000000000000000000000000000000000000000000000
0000033300000000000000000000000000000000000000000000000000000000000000000000000000000000000000000000000000000000000000000000
0000033300000000000000000000000000000000000000000000000000000000000000000000000000000000000000000000000000000000000000000000
0000033300000004444400005550000000000000000000000000000000000000000000000000000000000000000000000000000000000000000000000000
0000033300000004444400005550000000000000000900222222200000000000000000000000000000000000000222000000000000000000000000000000
0000033300000004444400005550000000000000000000000000000000000000000000000000000000222222222111000000000000000000000000000000
0000033300000004444400005550000000000000220000000000000002200000022000000000000000111111111111000000000000000000000000000000
0000033300000004444400005550000000000000112222222222222221100002211200000022222000111111111111000000000000000000000000000000
0000033300000004444400005550000000000000111111111111111111100001111100000011111000111111111111000000000000000000000000000000
0000033300000004444400005550000000000000111111111111111111100000110000000011111000111111111111000000000000000000000000000000
0000033300000004444400005550000000000000111111111111111111100000100000000011111000111111111111000000000000000000000000000000
0000033300000004444400005550000000000000111111111111111111100000100000000011111000111111111111000000000000000000000000000000
0000033300000004444400005550000000000000111111111111111111100000000000000011111000111111111111000000000000000000000000000000
0000033300000004444400005550000000000000000000000000000000000000000000000011111000111111111111000000000000000000000000000000
0000033300000004444400005550000000000000000000000000000000000000000000000011111000000000000000000000000000000000000000000000
0000033300000004444400005550000000000000000000000000000000000000000000000011111000000000000000000000000000000000000000000000
0000033300000004444400005550000000000000000000000000000000000000000000000000000000000000000000000000000000000000000000000000
0000033300000004444400005550000000000000000000000000000000000000000000000000000000000000000000000000000000000000000000000000
0000033300000004444400005550000000000000000000000000000000000000000000000000000000000000000000000000000000000000000000000000
0000033300000004444400005550000000000000000000000000000000000000000000000000000000000000000000000000000000000000000000000000
0000033300000004444400005550000000000000000000000000000000000000000000000000000000000000000000000000000000000000000000000000
0000033300000004444400005550000000000000000000000000000000000000000000000000000000000000000000000000000000000000000000000000
0000032222000004444400005550000002222000000000000000000000000000000022220000000000000000000000022220000000000000000000000000
2222221111222222222222222222222221111222222222222222222222222222222211112222222222222222222222211112222222222222222222222222
1111111111111111111111111111111111111111111111111111111111111111111111111111111111111111111111111111111111111111111111111111
1111111111111111111111111111111111111111111111111111111111111111111111111111111111111111111111111111111111111111111111111111
1111111111111111111111111111111111111111111111111111111111111111111111111111111111111111111111111111111111111111111111111111
1111111111111111111111111111111111111111111111111111111111111111111111111111111111111111111111111111111111111111111111111111
1111111111111111111111111111111111111111111111111111111111111111111111111111111111111111111111111111111111111111111111111111
1111111111111111111111111111111111111111111111111111111111111111111111111111111111111111111111111111111111111111111111111111
